#######
#######
#######
#    o#
#  @@o#
#  # A#
#######