#######
#     #
#A @  #
# @ @ #
###ooo#
#######
#######