#######
###0  #
###   #
# @@@ #
#   ###
#A 0###
#######
